X X X X X X X X X X M M M M M M M M X
X X X X X X X X X X M T G G E G G M M
X X X X X X X X X X M M M G E M E P M
X X X X X M M M M M M M M M M M E E M
X X X X X M G G D G G M X X X M M M M
X X X X X M M G M M S M X X X X X X X
X X X X X M M D M M M M X X X X X X X
X X X X X M O G M X X X X X X X X X X
X X X X X M M G M X X X X X X X X X X
X X X X X X M M M X X X X X X X X X X
X X X X X X X X X X X X X X X X X X X
X X X X X X X X X X X X X X X X X X X
X X X X X X X X X X X X X X X X X X X
X X X X X X X X X X X X X X X X X X X
X X X X X X X X X X X X X X X X X X X