M M M M X X X X X X X X X X X X X X X
M S O M X X X X X X X X X X X X X X X
M M M M X X X X X X X M M M M M M X X
X X X X X X X X X X X M G G G P M X X
X X X X X M M M M M M M G G M M M X X
X X X X X M G G G G M M G G M X X X X
X X X M M M G H H G M M G G M X X X X
X X X M G G E G G G G D G E M X X X X
X X X M T M E G G G M M G E M X X X X
X X X M M M G H G G M M G G M X X X X
X X X X X M M M G G M M G G M X X X X
X X X X X X X M G G M M G M M X X X X
X X X X X X X M G G G G G M X X X X X
X X X X X X X M M M M M M M X X X X X
X X X X X X X X X X X X X X X X X X X