X X X X X X X X X X
X X X X X X X X X X
X X X X X X X X X X
X X X X X X X X X X
X X X M M M X X X X
X X X M P M X X X X
X M M M G M X X X X
X M G G G M X X X X
X M O G G M X X X X
X M M M M M X X X X