X X X X X X X X X X X X X X X X X X X
X X X X X X X X X X X X X X X X X X X
X X X X X X X X X X X X X X X X X X X
X X X X X X X X X X X X X X X X X X X
X X X X X X X X X X X X X X X X X X X
X X X X X X X X X X X X X X X X X X X
X X X M M M M M M M X X X X X X X X X
X M M M G G G G G M M M M X X X X X X
X M O G G M M M G G G P M X X X X X X
X M M M M M X M G G M M M X X X X X X
X X X X X X X M M M M X X X X X X X X
X X X X X X X X X X X X X X X X X X X
X X X X X X X X X X X X X X X X X X X
X X X X X X X X X X X X X X X X X X X
X X X X X X X X X X X X X X X X X X X