X X X X X X X X X X M M M M M M M M X
X X X X X X X X X X M T G G G G G M M
X X X X X X X X X X M M M M M M E P M
X X X X X M M M M M M M X X X M E E M
X X X X X M G G D G G M X X X M M M M
X X X X X M M G M G S M X X X X X X X
X X X X X M M D M M M M X X X X X X X
X X X X X M O G M X X X X X X X X X X
X X X X X M M G M X X X X X X X X X X
X X X X X X M M M X X X X X X X X X X
X X X X X X X X X X X X X X X X X X X
X X X X X X X X X X X X X X X X X X X
X X X X X X X X X X X X X X X X X X X
X X X X X X X X X X X X X X X X X X X
X X X X X X X X X X X X X X X X X X X