M M M M X X X X X X X X X X X X X X X
M S O M X X X X X X X X X X X X X X X
M M M M X X X X X X X M M M M M M X X
X X X X X X X X X X X M H G G P M X X
X X X X X M M M M M M M G G M M M X X
X X X X X M G G G G H H D D M X X X X
X X X M M M G H H G M M G G M X X X X
X M M M G Y G G G G M G G G M X X X X
X M T G G G G G G G M M G M M X X X X
X M M M M M H H G G M M G M X X X X X
X X X X X M M M G G M M G M X X X X X
X X X X X X X M G G H H G M X X X X X
X X X X X X X M G G G G G M X X X X X
X X X X X X X M M M M M M M X X X X X
X X X X X X X X X X X X X X X X X X X