X X X X X X X X X X
X M M M M M M M X X
X M P G G G G M X X
X M M G G G G M M M
X X M G G G G G G M
X X M M M G G G M M
X X X X M G O G M X
X X X X M M M M M X
X X X X X X X X X X
X X X X X X X X X X