X X X X X X X X X X X X X X X X X X X
X X X X X X X X X X X X X X X X X X X
X X X X X X X M M M M M M M X X X X X
X X X X X X X M G G G G G M X X X X X
X X X M M M M M G M M M G M X X X X X
X X X M G G G G G G G G G M X X X X X
X M M M G M M G G G G M M M M M X X X
X M G G G M M G G G G G G G P M X X X
X M O G G M M G G G G G G G G M X X X
X M M G M M M M G M M M M M M M X X X
X X M G M X X M G M X X X X X X X X X
X X M G M X X M G M X X X X X X X X X
X X M G M M M M G M X X X X X X X X X
X X M G G G G G G M X X X X X X X X X
X X M M M M M M M M X X X X X X X X X