X X X X X X X X X X X X X X X X X X X
X M M M M M M M X X X X X X X X X X X
X M P E E E E M M M M M M M X X X X X
X M E E E E E D M M O G G M X X X X X
X M G D D D D D M M M M G M X X X X X
X M G D G G G G G M G G G M X X X X X
X M M M M M M G M M G M M M X X X X X
X X X X X X M G M G G D G M X X X X X
X X X X X X M G G G G D G G M X X X X
X X X X X X M M M M M M M M M X X X X
X X X X X X X X X X X X X X X X X X X
X X X X X X X X X X X X X X X X X X X
X X X X X X X X X X X X X X X X X X X
X X X X X X X X X X X X X X X X X X X
X X X X X X X X X X X X X X X X X X X