X X X X X X X X X X X X X X X X X X X
X X X X X X X X X X X X X X X X X X X
X X X X X X X M M M M M M M X X X X X
X X X X X X X M E E E E E M X X X X X
X X X X X X X M E M M M E M X X X X X
X M M M M X X M E E E P E M X X X X X 
M M E E M X X M M M G M M M X X X X X
M O E E M X X M M G G M X X X X X X X
M M M G M X X M G G M M X X X X X X X 
X X M G M X X M G M M X X X X X X X X
X X M G M X X M G M X X X X X X X X X
X X M G M X X M G M X X X X X X X X X
X X M G M M M M G M X X X X X X X X X
X X M G G G G G G M X X X X X X X X X
X X M M M M M M M M X X X X X X X X X