X X X X X X X X X X X X X X X X X X X
X X X X X X X X X X X X X X X X X X X
X X X X X X X M M M M M M M X X X X X
X X X X X X X M E E E E E M X X X X X
X X X M M M M M E M M M E M X X X X X
X X X M E E E E E E E E E M X X X X X 
X M M M E M M E E E E M M M M M X X X
X M E E E M M E E E E E E E E M X X X
X M O E E M M E E E E E E E P M X X X 
X M M E M M M M E M M M M M M M X X X
X X M E M X X M E M X X X X X X X X X
X X M E M X X M E M X X X X X X X X X
X X M E M M M M E M X X X X X X X X X
X X M E E E E E E M X X X X X X X X X
X X M M M M M M M M X X X X X X X X X